SO /home/tomas/school/cube3d/textures/brick_wall.png
NO /home/tomas/school/cube3d/textures/brick_wall.png
WE /home/tomas/school/cube3d/textures/brick_wall.png
EA /home/tomas/school/cube3d/textures/brick_wall.png
C         255,150,40
F         0,0,0



111111111111111111111111111111111111111111111111111111111111
100000000000000000000000000000000000000000000000000000000001
100000000000000000000000000000000000000000100000000000000001
100000010000000000000000000000000000000000000000000000000001
100000000000000000000000000000000000000000000000000000000001
100000000000000000000000000000000000000000000000000000000001
100000000000000000000000000000000000000000000000000000000001
100000000000000000000000000000000000000000000001000000000001
100000000000000000000000000000000000000000000000000000000001
1000000000000000000000000000N0000000000000000000000000000001
100000000000000000000000000000000000000000000000000000000001
100000000000000000000000000000000000000000000000000000000001
100000000000000001000000000000000000000000000000000000000001
100000000000000000000000000000000000000000000000000000000001
100000000000000000000000000000000000000000000000000000000001
100000000000000000000000000000000000000000000010000000000001
100000000000000000000000000000000000000000000000000000000001
100000000000000000000000000000000000000000000000000000000001
100000000000000000000000000000000000000000000000000000000001
111111111111111111111111111111111111111111111111111111111111
