SO /home/tomas/school/cube3d/textures/brick_wall.png
NO /home/tomas/school/cube3d/textures/brick_wall.png
WE /home/tomas/school/cube3d/textures/brick_wall.png
EA /home/tomas/school/cube3d/textures/brick_wall.png

F         220,100,0
C         225,30,0













    
           1111111111111111111111111
           1000000000110000000000001
           1011000001110000000000001
           1001000000000000000000001
           111111111011000001110000100000001
           100000000011000001111111111111111
11111111111111011100000010001
11110111111111011101010010001
11000000110101011100000010001
10000000000000001100000010001
10000000000000001101010010001
11000001110101011111011110N0111
11110111 1110101 101111010001
11111111 1111111 111111111111
