SO /home/tomas/school/cube3d/textures/brick_wall.png
NO /home/tomas/school/cube3d/textures/9e8e240693123e6-4116788467.png
WE /home/tomas/school/cube3d/textures/textured-stone-wall-png-2766135091.png
EA /home/tomas/school/cube3d/textures/transparent-hole-in-brick-wall-png-1829429816.png
C         0,0,139









F         128,128,128








           1111111111111111111111111
           10000000001100000000000S1
           1011000001110000000000001
           1001000000000000000000001
           11111111101100000111000011
           100000000011000001111111111111111
11111111111111011100000010001
11110111111111011101010010001
11000000110101011100000010001
1000000000000000110000001001
10000000000000001101010010001
110000011101010111110111100111
11110111 1110101 101111010001
11111111 1111111 111111111111
11111111 1111111 111111111111










